19 19 19 19 19 19 19 19 19 19 19 19 19 19 19 19 19 19 19 19 19 19 19 19 19 19 19 19 19 19 
19 19 19 19 19 19 19 19 19 19 19 19 19 19 19 19 19 19 19 19 19 19 19 19 19 19 19 19 19 19 
19 19 19 19 19 19 19 19 19 19 19 19 19 19 19 19 19 19 19 19 19 19 19 19 19 19 19 19 19 19 
19 19 19 19 19 19 19 19 19 19 19 19 19 19 19 19 19 19 19 19 19 19 19 4 4 4 4 19 19 19 
19 19 19 19 19 19 19 19 19 19 19 19 19 19 19 19 19 19 19 19 4 19 19 19 19 19 19 19 19 19 
19 10 19 19 19 19 19 19 19 19 19 19 19 19 19 19 19 4 19 19 19 19 19 19 19 19 19 19 19 19 
19 2 2 2 2 2 19 19 19 19 19 4 19 19 4 19 19 19 19 19 19 19 19 19 19 19 19 19 19 19 
19 2 2 2 2 2 19 19 4 19 19 19 19 19 19 19 19 19 19 19 19 19 19 19 19 19 19 19 19 19 
19 2 2 2 2 2 2 19 19 19 19 19 19 19 19 19 19 19 19 19 19 19 19 19 19 19 19 19 19 19 
19 7 7 7 7 7 2 2 19 19 19 4 19 19 19 19 19 19 19 19 19 19 19 19 19 19 19 19 19 19 
19 7 7 19 19 7 7 2 2 19 19 19 19 19 4 19 19 4 19 19 19 4 19 19 19 19 19 19 19 19 
19 7 19 19 19 19 7 7 2 2 19 19 19 19 19 19 19 19 19 19 19 19 19 4 19 19 19 19 19 19 
19 7 19 19 19 19 19 7 7 2 19 19 19 19 19 19 19 19 19 19 19 19 19 19 19 19 19 4 19 19 
19 7 19 19 19 19 19 19 19 19 19 19 19 19 19 19 19 19 19 19 19 19 19 19 19 19 4 4 4 19
19 19 19 19 19 19 19 19 19 19 19 19 19 19 19 19 19 19 19 19 19 19 19 19 19 19 19 19 19 19