19 19 19 19 19 19 19 19 19 19 19 19 19 19 19 19 19 19 19 19 19 19 19 19 19 19 19 19 19 19
19 19 19 19 19 19 19 19 19 19 19 19 19 19 19 19 19 19 19 19 19 19 19 19 19 19 19 19 10 19
19 19 19 19 19 19 19 19 19 19 19 19 19 19 19 19 19 19 19 19 19 12 12 12 12 12 12 12 12 19
19 19 19 19 7 19 19 19 19 19 19 19 19 7 19 19 19 19 19 7 19 19 19 19 19 19 19 19 19 19
19 7 19 19 19 19 19 19 19 19 7 19 19 19 19 12 19 19 19 19 19 19 19 19 19 19 19 19 19 19
19 19 7 19 19 19 19 19 19 19 19 19 19 19 19 19 19 19 19 19 19 19 19 19 19 19 19 19 19 19
19 19 19 19 19 7 19 19 19 7 19 19 19 19 19 19 19 19 19 19 19 19 19 19 19 19 19 19 19 19
19 2 2 2 2 2 2 2 2 2 2 2 2 2 2 2 2 2 2 2 2 2 2 2 19 19 19 19 19 19
19 19 19 19 19 19 19 19 19 19 19 19 19 19 19 19 19 19 19 19 19 19 19 19 4 19 19 19 19 19
19 19 19 19 19 19 19 19 19 19 19 19 19 19 19 19 19 19 19 19 19 19 19 19 19 4 19 19 19 19
19 19 19 19 19 19 19 19 19 19 19 19 19 19 19 19 19 19 19 19 19 19 19 19 19 19 19 19 4 19
19 19 19 19 19 19 19 19 19 19 19 4 19 19 19 19 19 19 19 19 19 19 19 19 19 19 19 4 3 19
19 19 19 19 4 19 19 19 19 19 4 3 4 19 19 19 19 19 19 19 19 19 4 19 19 19 4 4 3 19
19 19 19 4 3 4 19 19 19 4 3 4 3 4 19 19 19 19 19 19 19 19 3 19 19 4 3 3 4 19
19 19 19 19 19 19 19 19 19 19 19 19 19 19 19 19 19 19 19 19 19 19 19 19 19 19 19 19 19 19